################
#..............#
#..............#
#..............#
#.....++++.....#
#.....++++.....#
#.....++++.....#
#..............#
#..............#
#..............#
################